R 1080 720
NO ./wall/wall_nor.xpm
SO ./wall/wall_sou.xpm
WE ./wall/wall_wst.xpm
EA ./wall/wall_est.xpm
S ./wall/sprite.xpm
C 135,206,235
F 6,100,255



      1111111111111111111
1111111111111111111111111
1000000000110000000000001
1011000001110000002000001
100100010000000000000000111111111
111100001011000001110000000000001
100000000011000001110111100111111
11110111111111011100000010001
111101111111110111010100100011
110000001101010111000000100001
100002220000000011000000100011
10W01000000000001101010010001
1100010111010101111101111000111
11110111 1110101 101111010001
11111111 1111111 111111111111
