R 500 500

NO ./wall/wall_n.xpm
SO ./wall/wall_s.xpm
WE ./wall/wall_w.xpm
EA ./wall/wall_e.xpm

S "wall/sprite.xpm"
F 220,100,0
C 225,30,0

1111111111
1S00000001
1000000001
1000000001
1000000001
1000000001
1000000001
1000000001
10000000011111
10000000000001
11111111111111
