R 1003 1003

NO ./wall/wall_nor.xpm
SO ./wall/wall_sou.xpm
EA ./wall/wall_est.xpm
S ./wall/sprite2.xpm
C 24,24,24
F 123,123,123
WE ./wall/wall_wst.xpm


11111111111111111
10000000000000001
10022222222121001
10000000002222221
100000000000N0001
10000000000000001
10000000000000001
10000000000000001
10000000000000001
11111111111111111
