R 400 400

NO ./wall/wall_n.xpm
SO ./wall/wall_s.xpm
WE ./wall/wall_w.xpm
EA ./wall/wall_e.xpm

S ./wall/sprite.xpm
F 220,100,0
C 225,30,0


111111111111111111111111111111111111111111111
1N0000000000000000000000000000000000000000001
100000000000000000000000000000000000000000001
100000000000000000000000000000000000000000001
100000000000000000000000000000000000000000001
100000000000000000000000000000000000000000001
100000000000000000000000000000000000000000001
100000000000000000000000000000000000000000001
100000000000000000000000000000000000000000001
111111111111111111111111111111111111111111111

