R 800 800

NO ./wall/wall_nor.xpm
SO ./wall/wall_sou.xpm
EA ./wall/wall_est.xpm
WE ./wall/wall_wst.xpm

S ./wall/sprite2.xpm
C 24,24,24
F 123,123,123


11111111111111111
10000000000000001
10022222222121001
10000000002222221
101100000000N0001
10000111000110001
10000000000000001
10001100110011001
10110000000000001
11111111111111111
11111111111
10000000001
11111111111
