R 500 500

NO ./wall/wall_n.xpm
SO ./wall/wall_s.xpm
WE ./wall/wall_w.xpm
EA ./wall/wall_e.xpm

S ./wall/sprite.xpm
F 220,100,0
C 225,30,0

    1111111111
11111111110001
10000000000001
10200110000001
10202011000001
10E00001101101
10000000000001
10000000000001
10000000001011
11111111111111
