R 1000 1000

NO ./wall/wall_1.xpm
SO ./wall/wall_2.xpm
WE ./wall/wall_3.xpm
EA ./wall/wall_4.xpm

S ./wall/sprite.xpm
F 220,100,0
C 225,30,0

11111
100011
1000011
10200011
10E00001
11111111
