R 700 700

NO ./wall/wall_n.xpm
SO ./wall/wall_s.xpm
WE ./wall/wall_w.xpm
EA ./wall/wall_e.xpm

S "wall/sprite.xpm"
F 220,100,0
C 225,30,0

11111111111111
1S0000000000001111
1000000010111000001
100000000000000001
10000000011111111
10202020000020001
1000000001111111
1000000001
100000000111111111
1000000000000000001
10000000000000000001
111111111111111111111
