R 500 500

NO ./wall/wall_n.xpm
SO ./wall/wall_s.xpm
WE ./wall/wall_w.xpm
EA ./wall/wall_e.xpm

S ./wall/sprite.xpm
F 220,100,0
C 225,30,0

111111111111111111111111
100000000011100000000011
100000000011100000000011
100000000011100000000011
100000000011100000000011
100000000000000000000011
1000E0000000000000000011
100000000011100000000011
100000000011100000000011
100000000011100000000011
100000000011100000000011
100000000011100000000011
111111111111111111111111
