R 1000 1000

NO ./wall/wall_nor.xpm
SO ./wall/wall_sou.xpm
WE ./wall/wall_wst.xpm
EA ./wall/wall_est.xpm
S ./wall/sprite.xpm

C 255,200,160
F 122,122,122

1111111111
1000000001
1020200001
1002000001
1000000001
10000W0001
1000100001
1001000001
1000000001
1111111111
