R 1100 720
NO ./wall/wall_n.xpm
SO ./wall/wall_s.xpm
WE ./wall/wall_w.xpm
EA ./wall/wall_e.xpm
S ./wall/sprite.xpm
C 135,206,235
F 6,100,255


1111111
1002001
1002201
1E00001
1000001
1001001
1000101
1001001
1111111
