R 500 500

NO ./wall/wall_nor.xpm
SO ./wall/wall_sou.xpm
WE ./wall/wall_wst.xpm
EA ./wall/wall_est333.xpm

S ./wall/sprite.xpm
F 220,100,0
C 225,30,0

1111111111
1001010001
1000101001
1000E00001
1000002001
1002200001
1000011001
1000000001
1111111111
