R 1300 5000

NO ./wall/wall_nor.xpm
SO ./wall/wall_sou.xpm
WE ./wall/wall_wst.xpm
EA ./wall/wall_est.xpm

S ./wall/sprite.xpm

C 135,206,235
F 135,206,235

11111
1E011
10021
11111
