R 400 400

NO ./wall/wall_1.xpm
SO ./wall/wall_2.xpm
WE ./wall/wall_3.xpm
EA ./wall/wall_4.xpm

S ./wall/sprite.xpm
F 220,100,0
C 225,30,0

111111111111111111111
1S0000000000000000001
10000000101110000011111
10000000000000000200001
10000000011111100000111
102002000002000111111
1000000001111111
10000000011111
1000000001111111111
10000000000000000011
10000000000000000001
11111111111111111111
