R 1000 500

NO ./wall/wwall_n.xpm
SO ./wall/wwall_s.xpm
WE ./wall/wwall_w.xpm
EA ./wall/wwall_e.xpm
S ./wall/sprite.xpm

C 255,200,160
F 122,122,122

11111111111111111111
10000000000000000001
10202000001020200001
10202000001020200001
10000000000000000001
10000000010000000001
10000000100000000001
10000E01000000000001
10000000000000000001
10000000000000000001
10000000000000000001
10000000000000000001
10000000000000000001
10000000000000000001
11111111111111111111
