R 1500 1500

NO ./wall/wall_nor.xpm
SO ./wall/wall_sou.xpm
WE ./wall/wall_wst.xpm
EA ./wall/wall_est.xpm

S ./wall/sprite.xpm



C 135,206,235
F 135,206,235



1111111111
1001010001
1000100001
1000020001
1000E00001
1000000001
1000011001
1000000001
1111111111
