R 1000 500

NO ./wall/wall_nor.xpm
SO ./wall/wall_sou.xpm
WE ./wall/wall_wst.xpm
EA ./wall/wall_est.xpm
S ./wall/sprite.xpm

C 255,200,160
F 122,122,122

11111111111111111111
10000000000000000001
10202000001020200001
10202000001020200001
100000000000N0000001
10000000010000000001
10000000100000000001
10000001000000000001
10000000000000000001
10000000000000000001
10000000000000000001
10000000000000000001
10000000000000000001
10000000000000000001
11111111111111111111
