R 500 500

NO ./wall/wall_nor.xpm
SO ./wall/wall_sou.xpm
WE ./wall/wall_wst.xpm
EA ./wall/wall_est.xpm

S ./wall/sprite.xpm
F 0,255,0
C 135,206,235

1111111111
1001010221
1000102201
1000020001
1000E00001
1002200001
1000011001
1000000001
1111111111
