R 500 500
NO ./
SO ./
WE ./
EA ./

S ./
F 220,100,0
C 225,30,0

1111111111
1000000001
1010002001
1100000001
1010000001
1001002221
1000000001
1001000001
1011000001
1111111111
