 NO ./wall/wall_nor.xpm
SO ./wall/wall_sou.xpm
EA ./wall/wall_est.xpm
S ./wall/sprite.xpm
C 24,24,24
F 123,123,123
WE ./wall/wall_wst.xpm
R 1500 1500

11111111111111111
10000000000000001
10200000200000201
10000111111100101
10002000210020101
10000000010000101
10202020N02020201
11110000000000001
10002000200200001
10011000111100001
10200000200002001
10001111000000001
11111111111111111
