R 500 500

NO ./wall/wall_1.xpm
SO ./wall/wall_2.xpm
WE ./wall/wall_3.xpm
EA ./wall/wall_4.xpm

S "wall/sprite.xpm"
F 220,100,0
C 225,30,0

1111111111
10000000011
101000200111
1100000001111
10100000011111
100100222111111
100000000111111
1001000001111111
10110000011111111
111111111111111111
