R 500 500

NO ./wall/wall_1.xpm
SO ./wall/wall_2.xpm
WE ./wall/wall_3.xpm
EA ./wall/wall_4.xpm

S ./wall/sprite.xpm
F 220,100,0
C 225,30,0

111111111111111
1S0000000000000111
1000000010111000001
100000000000000001
100000000111111111
1020020000020001
10000000011111111
1000000001
100000000111111111
10000000000000000011
10000000000000000001
1111111111111111111
