R 5500 5500

NO ./wall/wall_nor.xpm
SO ./wall/wall_sou.xpm
WE ./wall/wall_wst.xpm
EA ./wall/wall_est.xpm
S ./wall/sprite.xpm

C 135,206,235
F 60,100,111

1111111111111111111111111
1000000000110000000000001
1011000001110000002000001
10010000000000E000000000111111111
111111111011000001110000000000001
100000000011000001110111100111111
11110111111111011100000010001
11110111111111011101010010001
11000000110101011100000010001
10002000000000001100000010001
10000000000000001101010010001
1100000111010101111101111000111
11110111 1110101 101111010001
11111111 1111111 111111111111
