R 1200 1200

NO ./wall/wall_1.xpm
SO ./wall/wall_2.xpm
WE ./wall/wall_3.xpm
EA ./wall/wall_4.xpm

S ./wall/sprite.xpm
F 220,100,0
C 225,30,0

1111111111
1000000001
1000111111
1020011111
1020201111
10E0000111
1000000001
1000000001
1000000001
1111111111
