R 500 500

NO ./wall/wall_1.xpm
SO ./wall/wall_2.xpm
WE ./wall/wall_3.xpm
EA ./wall/wall_4.xpm

S ./wall/sprite.xpm
F 220,100,0
C 225,30,0

11111111111111111111111111111111111111111111111111
10000000200000000000001111000000020000000000000111
10000000011111120001000011000000001111112000100001
10002200000011011110000111000220000001101111000011
10000000011000011000000111000000001100001100000011
10111111111011111111101111011111111101111111110111
10111111111011111111100010111111111011111111100011
1N000000000011111111100011011111111101111111110001
11111111111111111111111111111111111111111111111111
