R 1000 1000

NO ./wall/wall_n.xpm
SO ./wall/wall_s.xpm
WE ./wall/wall_w.xpm
EA ./wall/wall_e.xpm

S "wall/sprite.xpm"
F 220,100,0
C 225,30,0

1111111111
1S00000001
1000000001
1000000001
1020202001
1000000001
1000000001
1000000001
1000000001
1111111111
