R 1500 1500

NO ./wall/wall_nor.xpm
SO ./wall/wall_sou.xpm
EA ./wall/wall_est.xpm
S ./wall/sprite2.xpm
C 24,24,24
F 123,123,123
WE ./wall/wall_wst.xpm


11111111111111111
10000000000000001
10022222222220001
10000000000000001
10000000000000001
10001011111111001
10000120001000001
10001020001000001
10010021002200001
10000000S00000001
10022222222200001
11111111111111111
