R 640 480
NO ./wall/wall_1.xpm
SO ./wall/wall_2.xpm
WE ./wall/wall_3.xpm
EA ./wall/wall_4.xpm
S ./wall/sprite.xpm
FF 00,153,15
C 255,255,255

1111111111111111
1S00000000000011111
1000000010111000001
1000000000000000011
100000000111111111
1020020000020001
10000000011111111
1000000001
1000000001111111111
10000000000000000011
10000000000000000001
11111111111111111111
